%%%%%%
%P   %
%  % %
%..%o%
%%%%%%
