%%%%%%%
%P    %
%%% % %
%...%o%
%%%%%%%
