%%%%%%%%%%%%%%%%%%%%
%P G              .%
% %%%              %
%                  %
%                  %
%                  %
%%%%%%%%%%%%%%%%%%%%
