%%%%%%%%%%%%%%%%%%%%%%%%%%%%%%%
%.....%.................%.....%
%o%%%.%.%%%.%%%%%%%.%%%.%.%%%o%
%.%.....%......%......%.....%.%
%...%%%.%.%%%%.%.%%%%.%.%%%...%
%%%.%...%.%.........%.%...%.%%%
%...%.%%%.%.%%% %%%.%.%%%.%...%
%.%%%.......%GG GG%.......%%%.%
%...%.%%%.%.%%%%%%%.%.%%%.%...%
%%%.%...%.%.........%.%...%.%%%
%...%%%.%.%%%%.%.%%%%.%.%%%...%
%.%.....%......%......%.....%.%
%o%%%.%.%%%.%%%%%%%.%%%.%.%%%o%
%.....%........P........%.....%
%%%%%%%%%%%%%%%%%%%%%%%%%%%%%%%
