%%%%%%%%%%%%%%%%%%%%%%%%%%%%%%
%.......% % %............  %.%
%.......% % %%%%%% %%%%%%% % %
%.......%        %     % %   %
%%%%% %%%%% %%% %% %%%%% % %%%
%   % % % %   %    % ....%   %
% %%% % % % %%%%%%%% %%% %%% %
%       %.....%%     % % %   %
%%% % %%%%%%% %%%% %%% % % % %
% %           %%     %     % %
% % %%%%% % %%%% % %%% %%% % %
%   %     %. . . % %   %.%%% %
%.  %P%%%%% . . .% %%% %.....%
%%%%%%%%%%%%%%%%%%%%%%%%%%%%%%